deck1,deck2,wins,losses,ties,total,win_rate
aerodactyl-ex-a1a-farfetchd-a1,aerodactyl-ex-a1a-farfetchd-a1,17,17,1,35,49.5
aerodactyl-ex-a1a-farfetchd-a1,aerodactyl-ex-a1a-farfetchd-a1,17,17,1,35,49.5
aerodactyl-ex-a1a-farfetchd-a1,aerodactyl-ex-primeape-a1a,44,22,1,67,66.2
aerodactyl-ex-primeape-a1a,aerodactyl-ex-a1a-farfetchd-a1,22,44,1,67,33.3
aerodactyl-ex-a1a-farfetchd-a1,arcanine-ex-moltres-ex-a1,17,19,4,40,45.8
arcanine-ex-moltres-ex-a1,aerodactyl-ex-a1a-farfetchd-a1,19,17,4,40,50.8
aerodactyl-ex-a1a-farfetchd-a1,celebi-ex-serperior-a1a,28,47,6,81,37.0
celebi-ex-serperior-a1a,aerodactyl-ex-a1a-farfetchd-a1,47,28,6,81,60.5
aerodactyl-ex-a1a-farfetchd-a1,charizard-ex-arcanine-ex-a1,28,30,2,60,47.8
charizard-ex-arcanine-ex-a1,aerodactyl-ex-a1a-farfetchd-a1,30,28,2,60,51.1
aerodactyl-ex-a1a-farfetchd-a1,charizard-ex-moltres-ex-a1,35,25,4,64,56.8
charizard-ex-moltres-ex-a1,aerodactyl-ex-a1a-farfetchd-a1,25,35,4,64,41.1
aerodactyl-ex-a1a-farfetchd-a1,exeggutor-ex-a1-celebi-ex-a1a,40,80,8,128,33.3
exeggutor-ex-a1-celebi-ex-a1a,aerodactyl-ex-a1a-farfetchd-a1,80,40,8,128,64.6
aerodactyl-ex-a1a-farfetchd-a1,golem-druddigon-a1a,22,12,0,34,64.7
golem-druddigon-a1a,aerodactyl-ex-a1a-farfetchd-a1,12,22,0,34,35.3
aerodactyl-ex-a1a-farfetchd-a1,greninja-a1-mew-ex-a1a,17,22,2,41,43.1
greninja-a1-mew-ex-a1a,aerodactyl-ex-a1a-farfetchd-a1,22,17,2,41,55.3
aerodactyl-ex-a1a-farfetchd-a1,gyarados-ex-a1a-greninja-a1,155,58,12,225,70.7
gyarados-ex-a1a-greninja-a1,aerodactyl-ex-a1a-farfetchd-a1,58,155,12,225,27.6
aerodactyl-ex-a1a-farfetchd-a1,mewtwo-ex-gardevoir-a1,124,203,19,346,37.7
mewtwo-ex-gardevoir-a1,aerodactyl-ex-a1a-farfetchd-a1,203,124,19,346,60.5
aerodactyl-ex-a1a-farfetchd-a1,pikachu-ex-raichu-a1,22,10,5,37,64.0
pikachu-ex-raichu-a1,aerodactyl-ex-a1a-farfetchd-a1,10,22,5,37,31.5
aerodactyl-ex-a1a-farfetchd-a1,pikachu-ex-zebstrika-a1,115,122,16,253,47.6
pikachu-ex-zebstrika-a1,aerodactyl-ex-a1a-farfetchd-a1,122,115,16,253,50.3
aerodactyl-ex-a1a-farfetchd-a1,scolipede-a1a-weezing-a1,18,3,2,23,81.2
scolipede-a1a-weezing-a1,aerodactyl-ex-a1a-farfetchd-a1,3,18,2,23,15.9
aerodactyl-ex-a1a-farfetchd-a1,serperior-exeggutor-a1a,2,3,0,5,40.0
serperior-exeggutor-a1a,aerodactyl-ex-a1a-farfetchd-a1,3,2,0,5,60.0
aerodactyl-ex-primeape-a1a,aerodactyl-ex-primeape-a1a,68,68,6,142,49.3
aerodactyl-ex-primeape-a1a,aerodactyl-ex-primeape-a1a,68,68,6,142,49.3
aerodactyl-ex-primeape-a1a,arcanine-ex-moltres-ex-a1,32,42,6,80,42.5
arcanine-ex-moltres-ex-a1,aerodactyl-ex-primeape-a1a,42,32,6,80,55.0
aerodactyl-ex-primeape-a1a,celebi-ex-serperior-a1a,66,109,14,189,37.4
celebi-ex-serperior-a1a,aerodactyl-ex-primeape-a1a,109,66,14,189,60.1
aerodactyl-ex-primeape-a1a,charizard-ex-arcanine-ex-a1,60,54,4,118,52.0
charizard-ex-arcanine-ex-a1,aerodactyl-ex-primeape-a1a,54,60,4,118,46.9
aerodactyl-ex-primeape-a1a,charizard-ex-moltres-ex-a1,89,60,17,166,57.0
charizard-ex-moltres-ex-a1,aerodactyl-ex-primeape-a1a,60,89,17,166,39.6
aerodactyl-ex-primeape-a1a,exeggutor-ex-a1-celebi-ex-a1a,73,142,15,230,33.9
exeggutor-ex-a1-celebi-ex-a1a,aerodactyl-ex-primeape-a1a,142,73,15,230,63.9
aerodactyl-ex-primeape-a1a,golem-druddigon-a1a,15,24,4,43,38.0
golem-druddigon-a1a,aerodactyl-ex-primeape-a1a,24,15,4,43,58.9
aerodactyl-ex-primeape-a1a,greninja-a1-mew-ex-a1a,40,18,4,62,66.7
greninja-a1-mew-ex-a1a,aerodactyl-ex-primeape-a1a,18,40,4,62,31.2
aerodactyl-ex-primeape-a1a,gyarados-ex-a1a-greninja-a1,308,182,23,513,61.5
gyarados-ex-a1a-greninja-a1,aerodactyl-ex-primeape-a1a,182,308,23,513,37.0
aerodactyl-ex-primeape-a1a,mewtwo-ex-gardevoir-a1,197,406,37,640,32.7
mewtwo-ex-gardevoir-a1,aerodactyl-ex-primeape-a1a,406,197,37,640,65.4
aerodactyl-ex-primeape-a1a,pikachu-ex-raichu-a1,38,24,2,64,60.4
pikachu-ex-raichu-a1,aerodactyl-ex-primeape-a1a,24,38,2,64,38.5
aerodactyl-ex-primeape-a1a,pikachu-ex-zebstrika-a1,242,133,20,395,63.0
pikachu-ex-zebstrika-a1,aerodactyl-ex-primeape-a1a,133,242,20,395,35.4
aerodactyl-ex-primeape-a1a,scolipede-a1a-weezing-a1,30,8,1,39,77.8
scolipede-a1a-weezing-a1,aerodactyl-ex-primeape-a1a,8,30,1,39,21.4
aerodactyl-ex-primeape-a1a,serperior-exeggutor-a1a,5,7,2,14,40.5
serperior-exeggutor-a1a,aerodactyl-ex-primeape-a1a,7,5,2,14,54.8
arcanine-ex-moltres-ex-a1,arcanine-ex-moltres-ex-a1,29,29,1,59,49.7
arcanine-ex-moltres-ex-a1,arcanine-ex-moltres-ex-a1,29,29,1,59,49.7
arcanine-ex-moltres-ex-a1,celebi-ex-serperior-a1a,63,28,6,97,67.0
celebi-ex-serperior-a1a,arcanine-ex-moltres-ex-a1,28,63,6,97,30.9
arcanine-ex-moltres-ex-a1,charizard-ex-arcanine-ex-a1,32,42,4,78,42.7
charizard-ex-arcanine-ex-a1,arcanine-ex-moltres-ex-a1,42,32,4,78,55.6
arcanine-ex-moltres-ex-a1,charizard-ex-moltres-ex-a1,43,64,5,112,39.9
charizard-ex-moltres-ex-a1,arcanine-ex-moltres-ex-a1,64,43,5,112,58.6
arcanine-ex-moltres-ex-a1,exeggutor-ex-a1-celebi-ex-a1a,123,68,8,199,63.1
exeggutor-ex-a1-celebi-ex-a1a,arcanine-ex-moltres-ex-a1,68,123,8,199,35.5
arcanine-ex-moltres-ex-a1,golem-druddigon-a1a,20,15,4,39,54.7
golem-druddigon-a1a,arcanine-ex-moltres-ex-a1,15,20,4,39,41.9
arcanine-ex-moltres-ex-a1,greninja-a1-mew-ex-a1a,20,18,1,39,52.1
greninja-a1-mew-ex-a1a,arcanine-ex-moltres-ex-a1,18,20,1,39,47.0
arcanine-ex-moltres-ex-a1,gyarados-ex-a1a-greninja-a1,81,248,20,349,25.1
gyarados-ex-a1a-greninja-a1,arcanine-ex-moltres-ex-a1,248,81,20,349,73.0
arcanine-ex-moltres-ex-a1,mewtwo-ex-gardevoir-a1,241,220,35,496,50.9
mewtwo-ex-gardevoir-a1,arcanine-ex-moltres-ex-a1,220,241,35,496,46.7
arcanine-ex-moltres-ex-a1,pikachu-ex-raichu-a1,29,15,3,47,63.8
pikachu-ex-raichu-a1,arcanine-ex-moltres-ex-a1,15,29,3,47,34.0
arcanine-ex-moltres-ex-a1,pikachu-ex-zebstrika-a1,173,104,9,286,61.5
pikachu-ex-zebstrika-a1,arcanine-ex-moltres-ex-a1,104,173,9,286,37.4
arcanine-ex-moltres-ex-a1,scolipede-a1a-weezing-a1,18,17,2,37,50.5
scolipede-a1a-weezing-a1,arcanine-ex-moltres-ex-a1,17,18,2,37,47.7
arcanine-ex-moltres-ex-a1,serperior-exeggutor-a1a,2,2,1,5,46.7
serperior-exeggutor-a1a,arcanine-ex-moltres-ex-a1,2,2,1,5,46.7
celebi-ex-serperior-a1a,celebi-ex-serperior-a1a,139,139,7,285,49.6
celebi-ex-serperior-a1a,celebi-ex-serperior-a1a,139,139,7,285,49.6
celebi-ex-serperior-a1a,charizard-ex-arcanine-ex-a1,32,112,8,152,22.8
charizard-ex-arcanine-ex-a1,celebi-ex-serperior-a1a,112,32,8,152,75.4
celebi-ex-serperior-a1a,charizard-ex-moltres-ex-a1,99,137,14,250,41.5
charizard-ex-moltres-ex-a1,celebi-ex-serperior-a1a,137,99,14,250,56.7
celebi-ex-serperior-a1a,exeggutor-ex-a1-celebi-ex-a1a,138,202,13,353,40.3
exeggutor-ex-a1-celebi-ex-a1a,celebi-ex-serperior-a1a,202,138,13,353,58.5
celebi-ex-serperior-a1a,golem-druddigon-a1a,52,20,12,84,66.7
golem-druddigon-a1a,celebi-ex-serperior-a1a,20,52,12,84,28.6
celebi-ex-serperior-a1a,greninja-a1-mew-ex-a1a,51,39,4,94,55.7
greninja-a1-mew-ex-a1a,celebi-ex-serperior-a1a,39,51,4,94,42.9
celebi-ex-serperior-a1a,gyarados-ex-a1a-greninja-a1,275,430,53,758,38.6
gyarados-ex-a1a-greninja-a1,celebi-ex-serperior-a1a,430,275,53,758,59.1
celebi-ex-serperior-a1a,mewtwo-ex-gardevoir-a1,363,556,69,988,39.1
mewtwo-ex-gardevoir-a1,celebi-ex-serperior-a1a,556,363,69,988,58.6
celebi-ex-serperior-a1a,pikachu-ex-raichu-a1,40,40,9,89,48.3
pikachu-ex-raichu-a1,celebi-ex-serperior-a1a,40,40,9,89,48.3
celebi-ex-serperior-a1a,pikachu-ex-zebstrika-a1,335,187,23,545,62.9
pikachu-ex-zebstrika-a1,celebi-ex-serperior-a1a,187,335,23,545,35.7
celebi-ex-serperior-a1a,scolipede-a1a-weezing-a1,32,21,4,57,58.5
scolipede-a1a-weezing-a1,celebi-ex-serperior-a1a,21,32,4,57,39.2
celebi-ex-serperior-a1a,serperior-exeggutor-a1a,3,5,0,8,37.5
serperior-exeggutor-a1a,celebi-ex-serperior-a1a,5,3,0,8,62.5
charizard-ex-arcanine-ex-a1,charizard-ex-arcanine-ex-a1,59,59,7,125,49.1
charizard-ex-arcanine-ex-a1,charizard-ex-arcanine-ex-a1,59,59,7,125,49.1
charizard-ex-arcanine-ex-a1,charizard-ex-moltres-ex-a1,79,63,9,151,54.3
charizard-ex-moltres-ex-a1,charizard-ex-arcanine-ex-a1,63,79,9,151,43.7
charizard-ex-arcanine-ex-a1,exeggutor-ex-a1-celebi-ex-a1a,195,79,4,278,70.6
exeggutor-ex-a1-celebi-ex-a1a,charizard-ex-arcanine-ex-a1,79,195,4,278,28.9
charizard-ex-arcanine-ex-a1,golem-druddigon-a1a,39,12,4,55,73.3
golem-druddigon-a1a,charizard-ex-arcanine-ex-a1,12,39,4,55,24.2
charizard-ex-arcanine-ex-a1,greninja-a1-mew-ex-a1a,30,35,2,67,45.8
greninja-a1-mew-ex-a1a,charizard-ex-arcanine-ex-a1,35,30,2,67,53.2
charizard-ex-arcanine-ex-a1,gyarados-ex-a1a-greninja-a1,246,253,21,520,48.7
gyarados-ex-a1a-greninja-a1,charizard-ex-arcanine-ex-a1,253,246,21,520,50.0
charizard-ex-arcanine-ex-a1,mewtwo-ex-gardevoir-a1,252,405,50,707,38.0
mewtwo-ex-gardevoir-a1,charizard-ex-arcanine-ex-a1,405,252,50,707,59.6
charizard-ex-arcanine-ex-a1,pikachu-ex-raichu-a1,36,29,4,69,54.1
pikachu-ex-raichu-a1,charizard-ex-arcanine-ex-a1,29,36,4,69,44.0
charizard-ex-arcanine-ex-a1,pikachu-ex-zebstrika-a1,220,206,18,444,50.9
pikachu-ex-zebstrika-a1,charizard-ex-arcanine-ex-a1,206,220,18,444,47.7
charizard-ex-arcanine-ex-a1,scolipede-a1a-weezing-a1,20,16,0,36,55.6
scolipede-a1a-weezing-a1,charizard-ex-arcanine-ex-a1,16,20,0,36,44.4
charizard-ex-arcanine-ex-a1,serperior-exeggutor-a1a,2,1,0,3,
serperior-exeggutor-a1a,charizard-ex-arcanine-ex-a1,1,2,0,3,
charizard-ex-moltres-ex-a1,charizard-ex-moltres-ex-a1,76,76,10,162,49.0
charizard-ex-moltres-ex-a1,charizard-ex-moltres-ex-a1,76,76,10,162,49.0
charizard-ex-moltres-ex-a1,exeggutor-ex-a1-celebi-ex-a1a,188,120,17,325,59.6
exeggutor-ex-a1-celebi-ex-a1a,charizard-ex-moltres-ex-a1,120,188,17,325,38.7
charizard-ex-moltres-ex-a1,golem-druddigon-a1a,47,16,7,70,70.5
golem-druddigon-a1a,charizard-ex-moltres-ex-a1,16,47,7,70,26.2
charizard-ex-moltres-ex-a1,greninja-a1-mew-ex-a1a,30,50,6,86,37.2
greninja-a1-mew-ex-a1a,charizard-ex-moltres-ex-a1,50,30,6,86,60.5
charizard-ex-moltres-ex-a1,gyarados-ex-a1a-greninja-a1,288,352,43,683,44.3
gyarados-ex-a1a-greninja-a1,charizard-ex-moltres-ex-a1,352,288,43,683,53.6
charizard-ex-moltres-ex-a1,mewtwo-ex-gardevoir-a1,340,428,64,832,43.4
mewtwo-ex-gardevoir-a1,charizard-ex-moltres-ex-a1,428,340,64,832,54.0
charizard-ex-moltres-ex-a1,pikachu-ex-raichu-a1,32,40,3,75,44.0
pikachu-ex-raichu-a1,charizard-ex-moltres-ex-a1,40,32,3,75,54.7
charizard-ex-moltres-ex-a1,pikachu-ex-zebstrika-a1,232,272,22,526,45.5
pikachu-ex-zebstrika-a1,charizard-ex-moltres-ex-a1,272,232,22,526,53.1
charizard-ex-moltres-ex-a1,scolipede-a1a-weezing-a1,26,14,4,44,62.1
scolipede-a1a-weezing-a1,charizard-ex-moltres-ex-a1,14,26,4,44,34.8
charizard-ex-moltres-ex-a1,serperior-exeggutor-a1a,0,4,0,4,
serperior-exeggutor-a1a,charizard-ex-moltres-ex-a1,4,0,0,4,
exeggutor-ex-a1-celebi-ex-a1a,exeggutor-ex-a1-celebi-ex-a1a,270,270,11,551,49.7
exeggutor-ex-a1-celebi-ex-a1a,exeggutor-ex-a1-celebi-ex-a1a,270,270,11,551,49.7
exeggutor-ex-a1-celebi-ex-a1a,golem-druddigon-a1a,66,26,13,105,67.0
golem-druddigon-a1a,exeggutor-ex-a1-celebi-ex-a1a,26,66,13,105,28.9
exeggutor-ex-a1-celebi-ex-a1a,greninja-a1-mew-ex-a1a,86,51,4,141,61.9
greninja-a1-mew-ex-a1a,exeggutor-ex-a1-celebi-ex-a1a,51,86,4,141,37.1
exeggutor-ex-a1-celebi-ex-a1a,gyarados-ex-a1a-greninja-a1,478,662,53,1193,41.5
gyarados-ex-a1a-greninja-a1,exeggutor-ex-a1-celebi-ex-a1a,662,478,53,1193,57.0
exeggutor-ex-a1-celebi-ex-a1a,mewtwo-ex-gardevoir-a1,744,764,68,1576,48.6
mewtwo-ex-gardevoir-a1,exeggutor-ex-a1-celebi-ex-a1a,764,744,68,1576,49.9
exeggutor-ex-a1-celebi-ex-a1a,pikachu-ex-raichu-a1,88,51,7,146,61.9
pikachu-ex-raichu-a1,exeggutor-ex-a1-celebi-ex-a1a,51,88,7,146,36.5
exeggutor-ex-a1-celebi-ex-a1a,pikachu-ex-zebstrika-a1,555,292,37,884,64.2
pikachu-ex-zebstrika-a1,exeggutor-ex-a1-celebi-ex-a1a,292,555,37,884,34.4
exeggutor-ex-a1-celebi-ex-a1a,scolipede-a1a-weezing-a1,41,31,5,77,55.4
scolipede-a1a-weezing-a1,exeggutor-ex-a1-celebi-ex-a1a,31,41,5,77,42.4
exeggutor-ex-a1-celebi-ex-a1a,serperior-exeggutor-a1a,6,3,2,11,60.6
serperior-exeggutor-a1a,exeggutor-ex-a1-celebi-ex-a1a,3,6,2,11,33.3
golem-druddigon-a1a,golem-druddigon-a1a,104,104,18,226,48.7
golem-druddigon-a1a,golem-druddigon-a1a,104,104,18,226,48.7
golem-druddigon-a1a,greninja-a1-mew-ex-a1a,10,19,4,33,34.3
greninja-a1-mew-ex-a1a,golem-druddigon-a1a,19,10,4,33,61.6
golem-druddigon-a1a,gyarados-ex-a1a-greninja-a1,95,109,22,226,45.3
gyarados-ex-a1a-greninja-a1,golem-druddigon-a1a,109,95,22,226,51.5
golem-druddigon-a1a,mewtwo-ex-gardevoir-a1,90,168,32,290,34.7
mewtwo-ex-gardevoir-a1,golem-druddigon-a1a,168,90,32,290,61.6
golem-druddigon-a1a,pikachu-ex-raichu-a1,16,15,0,31,51.6
pikachu-ex-raichu-a1,golem-druddigon-a1a,15,16,0,31,48.4
golem-druddigon-a1a,pikachu-ex-zebstrika-a1,75,72,18,165,49.1
pikachu-ex-zebstrika-a1,golem-druddigon-a1a,72,75,18,165,47.3
golem-druddigon-a1a,scolipede-a1a-weezing-a1,58,7,11,76,81.1
scolipede-a1a-weezing-a1,golem-druddigon-a1a,7,58,11,76,14.0
golem-druddigon-a1a,serperior-exeggutor-a1a,52,105,10,167,33.1
serperior-exeggutor-a1a,golem-druddigon-a1a,105,52,10,167,64.9
greninja-a1-mew-ex-a1a,greninja-a1-mew-ex-a1a,20,20,2,42,49.2
greninja-a1-mew-ex-a1a,greninja-a1-mew-ex-a1a,20,20,2,42,49.2
greninja-a1-mew-ex-a1a,gyarados-ex-a1a-greninja-a1,137,122,20,279,51.5
gyarados-ex-a1a-greninja-a1,greninja-a1-mew-ex-a1a,122,137,20,279,46.1
greninja-a1-mew-ex-a1a,mewtwo-ex-gardevoir-a1,200,165,28,393,53.3
mewtwo-ex-gardevoir-a1,greninja-a1-mew-ex-a1a,165,200,28,393,44.4
greninja-a1-mew-ex-a1a,pikachu-ex-raichu-a1,17,17,2,36,49.1
pikachu-ex-raichu-a1,greninja-a1-mew-ex-a1a,17,17,2,36,49.1
greninja-a1-mew-ex-a1a,pikachu-ex-zebstrika-a1,92,116,13,221,43.6
pikachu-ex-zebstrika-a1,greninja-a1-mew-ex-a1a,116,92,13,221,54.4
greninja-a1-mew-ex-a1a,scolipede-a1a-weezing-a1,8,10,1,19,43.9
scolipede-a1a-weezing-a1,greninja-a1-mew-ex-a1a,10,8,1,19,54.4
greninja-a1-mew-ex-a1a,serperior-exeggutor-a1a,4,3,0,7,57.1
serperior-exeggutor-a1a,greninja-a1-mew-ex-a1a,3,4,0,7,42.9
gyarados-ex-a1a-greninja-a1,gyarados-ex-a1a-greninja-a1,1101,1101,76,2278,49.4
gyarados-ex-a1a-greninja-a1,gyarados-ex-a1a-greninja-a1,1101,1101,76,2278,49.4
gyarados-ex-a1a-greninja-a1,mewtwo-ex-gardevoir-a1,1857,984,190,3031,63.4
mewtwo-ex-gardevoir-a1,gyarados-ex-a1a-greninja-a1,984,1857,190,3031,34.6
gyarados-ex-a1a-greninja-a1,pikachu-ex-raichu-a1,93,208,15,316,31.0
pikachu-ex-raichu-a1,gyarados-ex-a1a-greninja-a1,208,93,15,316,67.4
gyarados-ex-a1a-greninja-a1,pikachu-ex-zebstrika-a1,412,1226,91,1729,25.6
pikachu-ex-zebstrika-a1,gyarados-ex-a1a-greninja-a1,1226,412,91,1729,72.7
gyarados-ex-a1a-greninja-a1,scolipede-a1a-weezing-a1,115,49,16,180,66.9
scolipede-a1a-weezing-a1,gyarados-ex-a1a-greninja-a1,49,115,16,180,30.2
gyarados-ex-a1a-greninja-a1,serperior-exeggutor-a1a,15,9,4,28,58.3
serperior-exeggutor-a1a,gyarados-ex-a1a-greninja-a1,9,15,4,28,36.9
mewtwo-ex-gardevoir-a1,mewtwo-ex-gardevoir-a1,1908,1908,133,3949,49.4
mewtwo-ex-gardevoir-a1,mewtwo-ex-gardevoir-a1,1908,1908,133,3949,49.4
mewtwo-ex-gardevoir-a1,pikachu-ex-raichu-a1,186,186,35,407,48.6
pikachu-ex-raichu-a1,mewtwo-ex-gardevoir-a1,186,186,35,407,48.6
mewtwo-ex-gardevoir-a1,pikachu-ex-zebstrika-a1,1239,933,143,2315,55.6
pikachu-ex-zebstrika-a1,mewtwo-ex-gardevoir-a1,933,1239,143,2315,42.4
mewtwo-ex-gardevoir-a1,scolipede-a1a-weezing-a1,66,165,19,250,28.9
scolipede-a1a-weezing-a1,mewtwo-ex-gardevoir-a1,165,66,19,250,68.5
mewtwo-ex-gardevoir-a1,serperior-exeggutor-a1a,26,13,1,40,65.8
serperior-exeggutor-a1a,mewtwo-ex-gardevoir-a1,13,26,1,40,33.3
pikachu-ex-raichu-a1,pikachu-ex-raichu-a1,21,21,1,43,49.6
pikachu-ex-raichu-a1,pikachu-ex-raichu-a1,21,21,1,43,49.6
pikachu-ex-raichu-a1,pikachu-ex-zebstrika-a1,110,111,12,233,48.9
pikachu-ex-zebstrika-a1,pikachu-ex-raichu-a1,111,110,12,233,49.4
pikachu-ex-raichu-a1,scolipede-a1a-weezing-a1,14,10,2,26,56.4
scolipede-a1a-weezing-a1,pikachu-ex-raichu-a1,10,14,2,26,41.0
pikachu-ex-raichu-a1,serperior-exeggutor-a1a,1,1,1,3,
serperior-exeggutor-a1a,pikachu-ex-raichu-a1,1,1,1,3,
pikachu-ex-zebstrika-a1,pikachu-ex-zebstrika-a1,650,650,28,1328,49.6
pikachu-ex-zebstrika-a1,pikachu-ex-zebstrika-a1,650,650,28,1328,49.6
pikachu-ex-zebstrika-a1,scolipede-a1a-weezing-a1,69,48,10,127,57.0
scolipede-a1a-weezing-a1,pikachu-ex-zebstrika-a1,48,69,10,127,40.4
pikachu-ex-zebstrika-a1,serperior-exeggutor-a1a,10,7,1,18,57.4
serperior-exeggutor-a1a,pikachu-ex-zebstrika-a1,7,10,1,18,40.7
scolipede-a1a-weezing-a1,scolipede-a1a-weezing-a1,67,67,7,141,49.2
scolipede-a1a-weezing-a1,scolipede-a1a-weezing-a1,67,67,7,141,49.2
scolipede-a1a-weezing-a1,serperior-exeggutor-a1a,43,37,4,84,52.8
serperior-exeggutor-a1a,scolipede-a1a-weezing-a1,37,43,4,84,45.6
serperior-exeggutor-a1a,serperior-exeggutor-a1a,175,175,2,352,49.9
serperior-exeggutor-a1a,serperior-exeggutor-a1a,175,175,2,352,49.9
